1111111111111111111111111111111111111111111111111111111111000011111111111111111111111111111111111111
1111111111111111111111111111111111111111111111111111111111000011111111111111111111111111111111111111
1111111111111111111111111111111111111111111111111111111111000011111111111111111111111111111111111111
1111111111111111111111111111111111111111111111111111111111000111000000000000000010000000000000000110
1111111111111111111111111111111111111111111111111111111111000111000000000000000010000000000000000110
1111111111111111111111111111111111111111111111111111111111000011000000000000000010000000000000000110
1111111111111111111111111111111111111111111111111101111111011111111111111111111010000000000000000110
1111111111111111111111111111111111111111111111111101111111011111111111111111111011000011000000000110
1111111111111111111111111111111111111111111111111000111111000000000000000110000011111111000000000110
1111111111111111111111111111111111111111111111100000001000000000000000000100000011111111000000000110
1111111111111111111111111111111111111111111111100000001000000000000000000100000011111111000000000110
1111111111111111111111111111111111111111111111100000001000000000000000000110001011001011000000101110
1111111111111111111111111111111111111111111111100000001111111111111111111000000000000000000000000000
1111111111111111111111111111111100000000000000000000000000000000000000001000000111111111100001111111
1110000000000000000000000000001100000000011111110000000000000000000000001000000111111111100001111111
1111111000000000000000000000000000000000011111110000000000000000000000001000001111111111100000000000
1110000011100000000111000000000000000000011111110000000000000000000000001000001000000000100000000000
1110000011100000000111000000000000000000010111010010010000000000000000001000001000000000100000000000
1110000011100000000111000000000000000000011111100000010000000100000000001000001000000000100000000000
1110000000000111000000000000000000000000011000100000010000000100000000001000001111111111100000000000
1110000000000111000000000000000000000000000000111111100011000100000000001000001101111101100000000000
1110000000000111000000000000000000000000000010011111100011000000000000001000001100000001100000000000
1110000000000000000000011111110000000000000000011111100000011111100000001000001011111111100000000000
1110000000000000000000011111110000000000000000011110100000011111100000001000001011101110100000000000
1110000000000000000000011111110100000000000000010100001000011111101000001000001000000000100000000000
1110000000000000000000000000000000000000000000000000001000011110101100001000001111101111100000000000
1110000000000000000000000000000000000000001100000100000000000000000000001000001000000000000000000000
1110000000000000000000000000000000000000001100010101111100001111110000001000001000000000000000000000
1110000000000000000000000000000000000000000000000101111100001111110000001000001000000000000000000000
1111111111100001000000000001000011110000010000000001111100111111110000001000001000000000000000000000
1111111111100001000000000001000000010000000100000001111100111110110000001000001000011111111111111111
1111111111100001000000000001000010010000000100011001111100001110110000001000001000010000000000000001
1111111111100001000000000001000000010000000100000000011100001100010000001000001000010000000000000001
1111111111100001000000000001000000010001111110001100010101000000010000001000001000010000000000000001
1111111111100001000000000001000001010011111111001100000001000010000000001000001000010000000000000001
1111111111100001000000000001000000010011111111000000000001000000000000001000001000010000000000000001
1111110111100001000000000001000000010011111111000100000000000000000000001000001000010000000000000001
1111010001100001000000000001000000010011111111000100000000000000000000001000001000010000000000000001
1110000001100001000000000001000000010010100101000100000000010000000000001000001000010000000000000001
1110100011100001000000000001000010010000000000000000000000000000000000001000001000010000000000000001
1000100011100001000000000001000000010000000000000000000000000000000000001000000000010000000000000001
1111100010100001000000000001000000110000000000000000000000000000000000001000000000010000000000000001
1000000000000001000000000001000000011111111111111111000011111111111111111000000000010000000000000001
1000000000000001000000000001000001111111111111111111000011111111111111111111100000010000000000000001
1000000000000001000000000001000001111111111111111111000011111111111111111111100000010000000000000001
1000000000000001000000000001000001111111111111111111000011111111111111111111100000010000000000000001
1111111111111111000000000001000001111111111111111111000011111111111111111111100000010000000000000001
1111111111111111000000000001000001111111111111111111000011111111111111111111100000010000000000000001
1111111111111111111111111111000001111111111111111111000011111111111111111111100000010000000000000001
1111111111111111111111111111000001111111111111111111000011111111111111111111100000010000000000000001
1111111111100000000000000000000001111111111111111111000011111111111111111111100000010000000000000001
1111111111100000000000000000000001111111111111111111000011111111111111111111100000010000000000000001
1111111111100000000000000000000001111111111111111111000011111111111111111111100000010000000000000001
1111111111100000000000000000000001111111111111111111000011111111111111111111100000010000000000000001
1111011111100000000000000000000001111111111111111111000011111111111111111111100000010000000000000001
1100011111100000000000000000000001111111111111111111000011111111111111111111100000010000000000000001
1110011111100000000000000000000001111111111111111111000011111111111111111111110000010000000000000001
1111011111100000000000000000000001111111111111111111000011111111111111111111110000010000000000000001
1000011111111111111111111111000011111100011111111111000011111111111111111111110000010000000000000001
0000000000000000000000000000000000000000000000000000000000000000000000000000000000010000000000000001
0000000000000000000000000000000000000000000000000000000000000000000000000000000000010000000000000001
0000000000000000000000000000000000000000000000000000000000000000000000000000000000010000000000000001
0000000000000000000000000000000000000000000000000000000000000000000000000000000000010000000000000001
1111111111111111111111111111000011111111111111111111100001111111111111111111111000010000000000000001
1111111111111111111111111111000011111111111111111111100001111111111111111111111000010000000000000001
1111111111111111111111111111000011111111111111111111100001111111111111111111111000010000000000000001
1111111111111111111111111111000011111111111111111111100001111111111111111111111000010000000000000001
1111111111111111111111111111000011111111111111111111100001111111111111111111111000000000000000000001
1111111111111111111111111111000011111111111111111111100001111111111111111111111000000000000000000001
1111000000000000000000001111000011111111111100000000100001000000000000001100001000000000000000000001
1110000000000000000000000111000011111111111101111111100001111111111111111100001000000000000000000001
1100000000000000000000000011000011111111111101111111100001111111111111111100001000000000000000000001
1100000000000000000000000011000011111111111101110000100000000000000000011100001000000000000000000001
1100000000000000000000000111000011111111110111110001100000000000000000011100001000000000000000000001
1100000000000000000000000011000011111111110111011111000000000000000000011100001000010000000000000001
1100000000000000000000000011000011111111111110011110100000000000000000011100001000010000000000000001
1100000000000000000000000000000011111111111110011110000011000000000000011100001000011111111111111111
1100000000000000000000000000000011111111111100011111000001000000000000011100001000011111111111111111
1100000000000000000000000000000011111111111100011110000001100000000000011100001000000000000000000001
1100000000000000000000000000000011111111111100011010000000000011110000011100001000011111111111111111
1100000000000000000000000000000011111111111100010000000000000011110000011100001000011111111111111111
1100000000000000000000000000000011111111110110010000000000000011110000011100001000011111111111111111
1100000000000000000000000011000011111111110110010000000000000011110000011100001000000001111111111111
1100000000000000000000000011000011111111110110010011111110100011110000011100000000000001111111111111
1100000000000000000000000011000011111111110110010011101110100000010000011100000000000001111111111111
1100000000000000000000000011000011111111111111010011111110100000010000011100000000000001111101111111
1100000000000000000000000011000011111111111111011111111111111111110000011100000000000001000000011111
1100000000000000000000000111000011111111111111000000000000000000000000011111000000000001110000011111
1100000000000000000000000011000011111111111101111111111111111111111111111111000000000001111000111111
1100000000000000000000000011000011111111110001111111111111111111111111111111000000010000001000111111
1110000000000000000000000111000011111111111111111111111111111111111111111111000000000000000000011111
1110000000000000000000000111000011111111111111111111111111111111111111111111000000000000000000011111
1111000000000000000000001111100111111111111111111111111111111111111111111111000000000000000000011111
1111111111111111111111111111111111111111111111111111111111111111111111111111000000000000000000011111
1111111111111111111111111111111111111111111111111111111111111111111111111111000000000000000000000000
1111111111111111111111111111111111111111111111111111111111111111111111111111111111111111111111111111
1111111111111111111111111111111111111111111111111111111111111111111111111111111111111111111111111111
1111111111111111111111111111111111111111111111111111111111111111111111111111111111111111111111111111
1111111111111111111111111111111111111111111111111111111111111111111111111111111111111111111111111111
1111111111111111111111111111111111111111111111111111111111111111111111111111111111111111111111111111